classification|enunciation|transEng|exCeb|exEng
Ako|Pronoun|Ah-Ko|I/me|Ako ang nagluto sa panihapon.|I am the one who cooked dinner.
Ikaw|Pronoun|Ee-kaw|You|Ikaw ba ang magdala sa libro?|Are you bringing the book?
Siya|Pronoun|See-yah|He/She|Siya ang akong higala.|She is my friend.
Kita|Pronoun|Kee-tah|We (inclusive)|Kita magdula unya.|We will play later.
Kami|Pronoun|Kah-mee|We (Exclusive)|Kami ang miadto sa tindahan.|We went to the store.
Kamo|Pronoun|Kah-moh|You (Plural)|Kamo ba ang muadto ugma?|Are you all going tomorrow?
Sila|Pronoun|See-lah|They|Sila ang mga bisita karon.|They are the guests today.
Ang|Article|Ahng|The|Ang balay nindot kaayo.|The house is very nice.
Sa|Preposition|Sah|In/At/To|Sa merkado mi nagkita.|We met at the market.
Ug|Conjunction|Oog|And|Si Ana ug si Ben nagtrabaho.|Ana and Ben are working.
Oo|Affirmative|Oh-oh|Yes|Oo, muadto ko ugma.|Yes, I will go tomorrow.
Dili|Negative|Dee-lee|No/not|Dili nako gusto ang pagkaon.|I don't like the food.
Unsa|Interrogative|Oon-sah|What|Unsa imong pangalan?|What is your name?
Asa|Interrogative|Ah-sah|Where|Asa ka nagtrabaho?|Where do you work?
Ngano|Interrogative|Ngah-no|Why|Ngano wala ka niadto?|Why didn't you go?
Kanus-a|Interrogative|Kah-noos-ah|When|Kanus-a ka moabot?|When will you arrive?
Pila|Interrogative|Pee-lah|How much/many|Pila ang presyo ani?|How much is this?
Gusto|Verb|Goo-stoh|Want|Gusto nako kaon og lechon.|I want to eat lechon.
Ganahan|Verb|Gah-nah-hahn|Like|Ganahan kaayo ko ug chocolates.|I really like chocolates.
Kailangan|Verb|Kai-lahng-ahn|Need|Kailangan nako moadto ron.|I need to go now.
Palihug|Expression|Pah-lee-hog|Please|Palihug kuha ug tubig.|Please get some water.
Salamat|Expression|Sah-lah-maht|Thank you|Salamat sa imong tabang.|Thank you for your help.
Pasayloa|Expression|Pah-sai-loh-ah|Sorry|Pasayloa ko sa akong sayop.|I apologize for my mistake.
Nindot|Adjective|Neen-doht|Nice/Good|Nindot kaayo ang tanom sa imong balay.|The plants in your house are very nice.
Pait|Adjective|Pah-eet|Bitter/Bad|Pait kaayo ang lasa sa tambal.|The medicine tastes very bitter.
Daghan|Adjective|Dahg-hahn|Many|Daghan ang mga bisita.|There are many guests.
Dako|Adjective|Dah-koh|Big|Dako ang balay ni Lola.|Grandma's house is big.
Gamay|Adjective|Gah-mai|Small|Gamay ra ang akong kwarta.|I have only a little money.
Bata|Noun/Adjective|Bah-tah|Child/Young|Bata pa siya ug maayo na.|She is young but very talented.
Tigulang|Adjective|Tee-goo-lahng|Old|Tigulang na siya pero kusgan gihapon.|He is old but still strong.
Bag-o|Adjective|Bah-go|New|Bag-o ang akong sapatos.|My shoes are new.
Karaan|Adjective|Kah-rah-ahn|Old (objects)|Karaan na ang among balay.|Our house is old.
Gwapa|Adjective|Gwah-pah|Beautiful|Gwapa kaayo si Maria.|Maria is very beautiful.
Bautan|Adjective|Bow-tahn|Kind|Bautan kaayo siya sa tanan.|He is very kind to everyone.
Duol|Adjective|Doo-ohl|Near|Duol ra ang eskwelahan sa balay.|The school is near the house.
Layo|Adjective|Lah-yoh|Far|Layo ang mall sa amoang lugar.|The mall is far from our place.
Sayo|Adjective|Sah-yoh|Hello/How are you|Sayo ko niabot karon buntag.|I arrived early this morning.
Ulahi|Adjective|Oo-lah-hee|Indeed|Ulahi kaayo siya sa meeting.|She was very late to the meeting.
Kumusta|Adjective|Koo-moos-tah|Maybe|Kumusta imong adlaw?|How was your day?
Tinuod|Adjective|Tee-noo-od|True|Tinuod ang iyang gisulti.|What he said is true.
Sayop|Adjective|Sah-yohp|Wrong|Sayop kaayo ang akong gibuhat.|What I did was very wrong.
Sakto|Adjective|Sahk-toh|Right|Sakto ka nga dili magdali-dali.|You're right not to rush.
Paglaum|Noun|Pahg-lah-oom|Hope|Ang paglaum kay importante sa kinabuhi.|Hope is important in life.
Lingaw	|Verb|Lee-ngahw|Enjoy/Fun|Lingaw kaayo mi sa beach.|We had so much fun at the beach.
Palihug|Expression|Pah-lee-hoog|Please|Palihug ko ug abli sa pultahan.|Please open the door for me.
Bati|Adjective|Bah-tee|Ugly|Bati kaayo ang daan nga building.|The old building is very ugly.
Pagkaon|Noun|Pahg-kah-on|Food|Lami ang pagkagion diri sa Cebu.|The food here in Cebu is delicious.
Inom|Verb|Ee-nom|Drink|Mag-inom ko ug tubig kay giuhaw ko.|I'll drink water because I'm thirsty.
Bulak|Noun|Boo-lahk|Flower|Nindot ang bulak sa among garden.|The flowers in our garden are beautiful.
Bahay|Noun|Bah-hai|House|Dako ug humot ang among balay.|Our house is big and fragrant.
Kalibutan|Noun|Kah-lee-boo-tahn|World|Daghan kaayo ug misteryo sa kalibutan.|The world is full of mysteries.
Adlaw|Noun|Ahd-law|Day/Sun|Init kaayo ang adlaw karon.|The sun is very hot today.
Gabi-i|Noun|Gah-bee-ee|Night|Taas ang gabi-i kung mag-binuntagay ka ug trabaho.|The night feels long when you work overnight.
Bulan|Noun|Boo-lahn|Month/Moon|Ang bulan kay kahayag karon sa gabii.|The moon is bright tonight.
Oras|Noun|Oh-rah-s|Hour|Unsa nga oras ang imong pag-abot?|What time did you arrive?
Panahon|Noun|Pah-nah-hon|Weather/Time|Maayo kaayo ang panahon karong adlawa.|The weather today is very nice.
Tubig|Noun|Too-big|Water|Kinahanglan nato ug tubig matag adlaw.	We need water every day.
Hangin|Noun|Hah-ng-een|Air|Bugnaw ang hangin karong buntag.|The air is cool this morning.
Utok|Noun|Oo-tok|Brain/Mind|Kinahanglan og klaro nga utok aron mag-solve sa problema.|A clear mind is needed to solve problems.
Lawas|Noun|Lah-wah-s|Body|Ang lawas kinahanglan ug pahulay.|The body needs rest.
Kasingkasing|Noun|Kah-sing-kah-sing|Heart|Ang kasingkasing kay puno ug gugma.|The heart is full of love.
Mata|Noun|Mah-tah|Eye|Ang mata kinahanglan protektahan batok sa alikabok.|The eye should be protected from dust.
Baba|Noun|Bah-bah|Mouth|Ampingi ang imong baba samtang mokaon.|Take care of your mouth while eating.
Kamot|Noun|Kah-mot|Hand|Palihug ko ug hatag ug kamot aron makatabang.|Please lend a hand to help.
Tiil|Noun|Tee-eel|Foot/Leg|Nasamad ang akong tiil samtang naglakaw.|I hurt my foot while walking.
Kasaligan|Adjective|Kah-sah-lee-gan|Trustworthy|Siya usa ka kasaligan nga kauban sa trabaho.|He is a trustworthy colleague.
Ayaw|Verb|Ah-yaw|Don’t|Ayaw lang pagbuhat ana kung wala ka kahibalo.|Don’t do it if you don’t know how.
Magsugod|Verb|Mag-soo-god|Start|Magsugod ko ug trabaho ugma.|I’ll start work tomorrow.
Dula|Verb|Doo-lah|Play|Magdula mi ug volleyball sa hapon.|We'll play volleyball in the afternoon.
Matulog|Verb|Mah-too-log|Sleep|Matulog nako kay kapoy kaayo.|I'm going to sleep because I'm very tired.
Bangon|Verb|Bahng-on|Wake up|Bangon na, hapit na magsugod ang klase.|Wake up; class is about to start.
Kwarta	Noun|Kwar-tah|Money|Kwarta ra ang gikinahanglan para sa proyekto.|Only money is needed for the project.
Alimyon|Noun|Ah-lee-my-on|Smell|Lami ang alimyon sa luto ni mama.|The smell of mom's cooking is delicious.
Bahog|Adjective|Bah-hog|Dirty|Ang iyang sapatos kay bahog na kaayo.|His shoes are very dirty.
Limpyo|Adjective|Leem-pyo|Clean|Limpyo ang akong kwarto kay bag-o ko naglimpyo.|My room is clean because I just cleaned it.
Kusog|Adjective|Koo-sog|Strong|Kusog kaayo ang hangin karong gabii.|The wind is very strong tonight.
Huyang|Adjective|Hoo-yahng|Weak|Huyang siya tungod sa sakit.|He is weak because of illness.
Kapoy|Adjective|Kah-poy|Tired|Kapoy na kaayo ko sa trabaho.|I am very tired from work.
Gutom|Adjective|Goo-tom|Hungry|Gutom na kaayo ko, magkaon na ta.|I’m very hungry; let’s eat.
Uhaw|Adjective|Oo-hahw|Thirsty|Uhaw na kaayo ko, palihug ko ug tubig.|I'm very thirsty; please give me some water.
Dungog|Noun|Doong-og|Fame/Honor|Daghang dungog ang iyang nadawat sa iyang trabaho.|He received much honor from his work.
Tulubagon|Noun|Too-loo-bah-gon|Responsibility|Ang tulubagon kay kinahanglan atimanon.|Responsibilities must be taken seriously.
Lingkod|Verb|Leeng-kod|Sit|Lingkod una kay naghulat ta sa order.|Sit down while we wait for the order.
Bangon|Verb|Bah-ngon|Stand|Bangon aron makita ang view.|Stand up to see the view.
Maghuwat|Verb|Mag-hoo-waht|Wait|Maghuwat ra ta diri.|We’ll just wait here.
Dali|Adjective|Dah-lee|Quick|Dali ra nga trabaho kung magtinabangay.|It’s quick work if we help each other.
Hinay|Adjective|Hee-nai|Slow|Hinay kaayo siya molihok sa klase.|He moves very slowly in class.
Lakaw|Verb|Lah-kaw|Walk|Maglakaw ta padulong sa merkado.|Let's walk to the market.
Dagan|Verb|Dah-gahn|Run|Dagan aron dili malangay sa klase.|Run so you won't be late for class.
Luto|Verb|Loo-toh|Cook|Lutoon nako ang sinugba nga isda unya.|I’ll cook the grilled fish later.
Kaon|Verb|Kah-on|Eat|Magkaon ta ug prutas aron himsog ang lawas.|Let’s eat fruits for a healthy body.
Maminaw|Verb|Mah-mee-now|Listen|Maminaw ko sa imong istorya.|I’ll listen to your story.
Tinguha|Noun|Tee-ngoo-hah|Desire|Ang akong tinguha mao ang makat-on pa gyud.|My desire is to keep learning.
Gihigugma|Verb|Gee-hee-goog-mah|Love|Gihigugma nako ang akong pamilya.|I love my family.
Lami|Adjective|Lah-mee|Delicious|Lami kaayo ang pagkaon sa among probinsya.|The food in our province is very delicious.
Tambal	|Noun|Tahm-bal|Medicine|Kinahanglan ko ug tambal kay gisakit akong ulo.|I need medicine because I have a headache.
Bahandi|Noun|Bah-han-dee|Treasure|Bahandi ang mga kaalam nga nakuha sa eskwela.|Knowledge gained from school is a treasure.


